OOOOOOOOOOOOOOOOOOOOOOOOO
OOOOOOOOOOOOOOOOOOOOOOOOO
OOOXOOOOO00G00OOOOOOOXOOO
OOOXOOOOO00000OOOOOOOXOOO
OOOXOOOOOOOOOOOOOOOOOXOOO
OOOOXOXOXOXOXOXOXOXOXOOOO
OOOXOXOXOXOXOXOXOXOXOXOOO
OOOOOOOOOOOOOOOOOOOOOOOOO
OOOOOOOOOOOOOOOOOOOOOOOOO
OOOOOOOOOOOOOOOOOOOOOOOOO
OOOOOOOOOOOOOOOOOOOOOOOOO