XOOOOOOOOOOOOOOOOOOOOOOOX
OOOOOOOOOOOOOOOOOOOOOOOOX
OOOXXXXXXXXXXXXXXXXXXXOOX
OOOXXXXXXXXXXXXXXXXXXXOOX
OOOXXXXXXXXXXXXXXXXXXXOOX
OOOXXXXXXXXXXXXXXXXXXXOOX
OOOXXXXXXXXXXXXXXXXXXXOOX
OOOOOOOOOOOOOOOOOOOOOOOOX
XOOOOOOOOOOOOOOOOOOOOOOOX
XOOOOOOOOOOOOOOOOOOOOOOOX
XOOOOOOOOOOOOOOOOOOOOOOOX