OOOOOOOOOOOOOOOOOOOOOOOOO
OOOOOOOOOOOOOOOOOOOOOOOOO
OOOXXXGXXXXXXXXGXXXXXXOOO
OOOXXXXXXXXXXXXXXXXXXXOOO
OOOXXXXXXXXXXXXXXXXXXXOOO
OOOXXXXXXXXXXXXXXXXXXXOOO
OOOXXXXXXXXXXXXXXXXXXXOOO
OOOOOOOOOOOOOOOOOOOOOOOOO
OOOOOOOOOOOOOOOOOOOOOOOOO
XXXOOOOOOOOOOOOOOOOOOOOOO
XXXOOOOOOOOOOOOOOOOOOOOOO