XXXXXOOOOOXXXXXOOOOOXXXXX
OOOOOXXXXXOOOOOXXXXXOOOOO
OOGOOOOOOOXXXXXOOOOOOOGOO
OOOOOXXXXXOOOOOXXXXXOOOOO
XXXXXOOOOOOOGOOOOOOOXXXXX
OOOOOXXXXXOOOOOXXXXXOOOOO
XXXXXOOOOOXXXXXOOOOOXXXXX
OOOOOXXXXXOOOOOXXXXXOOOOO
XXXXXOOOOOXXXXXOOOOOXXXXX
OOOOOXXXXXOOOOOXXXXXOOOOO
XXXXXOOOOOXXXXXOOOOOXXXXX