OOOOOOOOOOOOOOOOOOOOOOOOO
OOOOOOOOOOOOOOOOOOOOOOOOO
OOOXXXXXXXXXXXXXXXXXXXOOO
OOOXXXXXOOOOOOOXXXXXXXOOO
OOOXXXXXOOOGOOOXXXXXXXOOO
OOOXXXXXOOOOOOOXXXXXXXOOO
OOOXXXXXXXXXXXXXXXXXXXOOO
OOOOOOOOOOOOOOOOOOOOOOOOO
OOOOOOOOOOOOOOOOOOOOOOOOO
OOOOOOOOOOOOOOOOOOOOOOOOO
OOOOOOOOOOOOOOOOOOOOOOOOO