OOOOOOOOOOOOOOOOOOOOOOOOO
OOOOOOOOOOO0OOOOOOOOOOOOO
XXOOXXXXXXOOGOOXXXXXXOOXX
XXXOOXXXXXXXXXXXXXXXOOXXX
XXXXOOXXXXXXXXXXXXXOOXXXX
XXXXXOOXXXXXXXXXXXOOXXXXX
XXXXXXOOXXXXXXXXXOOXXXXXX
OOOOOOOOOOOOOOOOOOOOOOOOO
OOOOOOOOOOOOOOOOOOOOOOOOO
OOOOOOOOOOOOOOOOOOOOOOOOO
OOOOOOOOOOOOOOOOOOOOOOOOO