OOOOOOOOOOOOOOOOOOOOOOOOO
OOOOOOOOOOOOOOOOOOOOOOOOO
OOOXOOOOO00G00OOOOOOOXOOO
OOOXOOOOO00000OOOOOOOXOOO
OOOXOOOOOOOOOOOOOOOOOXOOO
OOOXXXXXXXXXXXXXXXXXXXOOO
OOOXXXXXXXXXXXXXXXXXXXOOO
OOOOOOOOOOOOOOOOOOOOOOOOO
OOOOOOOOOOOOOOOOOOOOOOOOO
OOOOOOOOOOOOOOOOOOOOOOOOO
OOOOOOOOOOOOOOOOOOOOOOOOO